1 1 1 1 0 1 
1 1 1 1 0 0 
1 1 12 1 1 1 
0 6 4 8 11 1 
1 1 1 1 1 1 
0 4 1 1 6 0 
1 0 1 1 0 1 
