1 1 1 0 1 1 
0 0 6 0 0 1 
1 0 6 6 0 1 
1 0 0 0 0 1 
1 6 1 1 1 1 
0 6 4 0 3 1 
1 1 4 1 0 1 
