1 1 1 1 1 1 
1 1 1 6 7 1 
1 12 0 0 1 1 
1 1 1 0 0 1 
1 1 0 0 1 1 
1 0 0 1 1 1 
1 0 1 1 1 1 
