1 1 1 1 0 1 
1 12 1 0 0 1 
1 0 0 0 1 1 
1 1 1 4 1 1 
1 5 1 4 4 1 
1 4 4 4 1 1 
1 1 1 1 1 1 
