1 1 1 1 1 1 
1 9 8 6 4 1 
1 1 1 1 0 1 
1 1 0 0 0 1 
1 1 0 1 1 1 
1 12 0 0 0 1 
1 1 1 1 0 1 
