1 1 1 1 8 1 
1 1 1 1 6 1 
0 0 0 1 4 1 
1 1 0 0 0 0 
12 1 1 1 0 1 
1 0 0 0 0 1 
1 0 1 1 1 1 
