1 8 1 1 0 1 
1 0 0 1 0 1 
1 1 0 0 0 1 
0 6 0 1 1 1 
1 1 0 6 0 1 
1 12 6 1 0 1 
1 1 1 1 0 1 
