1 1 1 1 0 1 
1 1 1 1 0 0 
1 1 10 1 1 1 
0 6 4 8 9 1 
1 1 1 1 1 1 
0 4 1 1 6 0 
1 0 1 1 0 1 
